
NO  ./path_to_the_north_texture
SO ./path_to_the_south_texture
WE ./Users/aelbouab/Desktop/cub3D/zabizabi


EA ./path_to_the_east_texture


F 11,220,100

C 225,214,2

1111111111111111111111111111111
1111111111111111111111111111111
1100000000000100000000000011111
1100000000011000000001111111111
1011000000000000N00011111111111
1111111111111111111111111111111
1111111111111111111111111111111
1111111111111111111111111111111