
NO  ./path_to_the_north_texture


SO ./path_to_the_south_texture


WE ./Users/aelbouab/Desktop/cub3D/zabizabi


EA ./path_to_the_east_texture

C 225,214,2

F 11,220,100

   
1111111111111111111111111111
1111111111111111111111111111
11001 10000000000000000000001111
110001000000000000000000001111
10110000000000000000000001111
10000000000000000000000001111
10000000000000000N00000001111
1100000000000000000000001111
10000000000000000000000001111
11111111000000000000000001111
11111111111111111111111111111
