
NO  ./path_to_the_north_texture
SO ./path_to_the_south_texture
WE ./Users/aelbouab/Desktop/cub3D/zabizabi


EA ./path_to_the_east_texture


F 11,220,100

C 225,214,2

1111111111111111111111111
1111                        1
1111111111     111111111111101
11111111111111111111111110011
100000000000100000000000011
1000000000110000000000001
101100000111000N0000000111111
111111110000111111111110000011
1111111111111111111111111111111