
NO  ./path_to_the_north_texture
SO ./path_to_the_south_texture
WE ./Users/aelbouab/Desktop/cub3D/zabizabi


EA ./path_to_the_east_texture


F 11,220,100

C 225,214,2

111111111111111111111
1111111111100000111111
110000000000010000001111
11000000000010N001001111
101100000000000000101111
111111111111111111111111