
NO  ./path_to_the_north_texture


SO ./path_to_the_south_texture


WE ./Users/aelbouab/Desktop/cub3D/zabizabi


EA ./path_to_the_east_texture

C 225,214,2

F 11,220,100


1111111111
   
11111111111111
11001 1000011
11000100011
1011000011
1000000011
1000000011
1100N00011
1000000011
1111111111