
NO  ./path_to_the_north_texture
SO ./path_to_the_south_texture
WE ./Users/aelbouab/Desktop/cub3D/zabizabi


EA ./path_to_the_east_texture


F 11,220,100

C 225,214,2

111111111111111111111111
111111111111111111111111
110000000000010000001111
110000000001100000001111
1011000000000000N0001111
111111111111111111111111