
EA ./images/8.png

WE ./images/8.png

NO ./images/8.png            


SO ./images/8.png





C 50,10,10

F 50,50,50


1111111111111111111111111111
11001 10000000000000D000000011
110001000000000000001000001111
10110000000000001000100001111
1000000000000D000000D00001111
100000D000000000000010001111
1100000000000000E000D0000111
1000000000000D000000100001111
11111111000000000000D00001111
1111111111111111111111111111