WE      ./Users/aelbouab/Desktop/cub3D/z
NO  ./path_to_the_north_texture
EA ./path_to_the_east_texture
SO ./path_to_the_south_texture



F 11,220,0
C 225,225,2

11111111111111111111111111111
11001 10000000000000000000001111
110001000000000000000000001111
10110000000000001000000001111
10000000000000000000000001111
1000000000000000E00000001111
1100000000000000000000001111
10000000001000000000000001111
1111111101 100000000000001111
1111111111 11111111111111111
