
EA ./images/7.png

WE ./images/7.png

NO ./images/7.png            


SO ./images/7.png





C 50,10,10

F 50,50,50


1111111111111111111111111111
11001 100000000000000000000011
110001000000000000000000001111
10110000000000001000000001111
10000000000000000000000001111
1000000000000000000000001111
1100000000000000N00000001111
10000000000000000000000001111
11111111000000000000000001111
11110000000000000000000011111
11110000000000000000000011111
11110000000000000000000011111
11110000000000000000000011111
11110000000000000000000011111
11110000000000000000000011111
11110000000000000000000011111
1111111111111111111111111111
        
111111