
EA ./images/1.png                 

WE ./images/2 2.png                   

NO  ./images/4.png            


SO ./images/5.png
       




C 0,225,225                        

F 225,225,225


1111111111111111111111111111
11001 100000000000000000000011
11000100000000000000000001111
10110000000000001000000001111
10000000000000000000000001111
1000000000000000000000001111
1100000000000000E00000001111
10000000000000000000000001111
11111111000000000000000001111
1111111111111111111111111111
