
NO  ./path_to_the_north_texture
SO ./path_to_the_south_texture
WE ./Users/aelbouab/Desktop/cub3D/zabizabi


EA ./path_to_the_east_texture


F 11,220,100

C 225,214,2

1111111111111111111111111
1111111111111111111111111
1111111111111111111111101
1111111111111111111111111
1000000000110000000000001
1011000001110000E00000001
1111111111111111111111111