
EA ./images/1.png

WE ./images/1.png

NO ./images/1.png            


SO ./images/1.png





C 50,10,10

F 50,50,50


1111111111111111111111111111111111111111
11001 10000000000000D00000000000000000011
1100010000000000000010000000001D1D1000001111
1011000000000000100001000100000000000111
1000000000001D1000000D0000000000000001111
100000000000000000001100110000000000011
11000000000000000000D0000100001D1000011
100000000000000000001000010000DED0000111
1111111100000000000000000100001D10000111
1111111100000000000000000100000000000111
11111111000000000001D10000100000000000111
11111111000000011111D11111100000000000111
111111110000000DDDDD0DDDDDD00000000000111
11111111000000011111D1111110100000000000111
11111111000000000001D10000100000000000111
1111111100000000000000000100000000000111
1111111100000000000010000100000000000111
11111111111111111111D11D1111111111111111
11111111111111111111D11D111111111111111
11001 10000000000000000000000000000000011
1100010000000000000010000000001D1D1000001111
1011000000000000100001000100000000000111
1000000000001D1000000D0000000000000001111
100000000000000000001100110000000000011
11000000000000000000D0000100001D1000011
100000000000000000001000010000D0D0000111
11111111000000000000D0000100001D10000111
1111111100000000000010000100000000000111
1111111100000000000010000100000000000111
1111111100000000000010000100000000000111
1111111100000000000010000100000000000D11
1111111100000000000010000100000000000111
1111111100000000000010000100000000000111
1111111100000000000010000100000000000111
1111111100000000000010000100000000000111
1111111111111111111111111111111111111111
